-------------s--
----t-----------
---------t------
-------------^--
----*^---s------
----------------
-----t----------
----------------
--*^-------*^t--
----------------
---------s------
----t-----------
----------------
-----s------s---
----------------
----------------